
SO ./coin.xpm
NO ./coin.xpm
WE ./coin.xpm
EA ./coin.xpm


  F 220,100,1
                1111111111111111111111111
                1000000000110000000000001
                1011000001110000000000001
                1001000000000000000000001
        111111111011000001110000000000001
        100000000011000001110111111111111
        11110111111111011100000010001
        111110111111111011101010010001
        11000000110101011100000010001
        100000000000000011000000000011
        1000000000000000110101001000001
        11000001110101011101011010N111
        11110111 1110101 101111010001
        11111111 1111111 111111111111


 C 225,30,0      
